10
11
1111111111
1000414001
1030010301
1100000001
1110300111
1030001221
1030111221
1000001221
1003000001
1400000001
1111111111
2,2