13
19
2,13
1111111111111111111
1111114020010001111
1111110120000001111
1111110112210111111
1100102211100000111
1030122200030100301
1400022011001101101
1111311310301000101
1111110004130330101
1110030101001031101
1110000000000000001
1114011111111111001
1111111111111111111
