11
18
5,6
111111111111111111
111111111104111111
110030000003011111
100011011000112221
101330303313112221
101000000010002221
100310111330402221
143003300301122221
111300000001111111
111041111111111111
111111111111111111
