14
19
7,17
1111111111111111111
1111111111000000041
1111111110003300001
1111111100330030001
1111111003000030001
1111111400033011111
1001111111101100001
1240000000000033301
1210111111101100011
1210111111120130311
1222222222220100001
1111111111111100341
1111111111111110011
1111111111111111111
