14
16
10,2
1111111111111111
1111220410001111
1111220000001111
1111220010011111
1111111110010011
1110000000000001
1110010011001001
1111011401111011
1003001111101001
1010300300103001
1003003004100411
1111011011111111
1111000011111111
1111111111111111
