11
19
8,11
1111111111111111111
1111100011111111111
1111130011111111111
1111100311111111111
1114030301111111111
1110101101111111111
1000101101111100221
1030034000000004221
1111101110101100221
1111140000111111111
1111111111111111111