15
15
4,4
111111111111111
100000001111111
140000001111111
110111101001111
110101100041111
103330300331111
100101103001111
100101100301111
111100333031001
110001100022221
110100010122021
110041010112221
111111030012221
111111104011111
111111111111111