14
19
11,10
1111111111111111111
1111111111110422221
1111111111110022221
1400010030300022221
1033313003010022221
1003000003010022221
1033013030311111111
1003010000411111111
1101111111111111111
1000014000111111111
1000003000111111111
1003313300011111111
1400010000111111111
1111111111111111111