13
17
4,7
11111111111111111
10000000000000411
10101111111000011
10100303030310011
10100030300011011
10100303031112221
10100030300112221
10111333030112221
14000010110112221
11111000110112221
11111111100000111
11111111140000111
11111111111111111
